11111111111111111
1000000000000C001
1000C000000000001
100011111000C0001
10E01000000000001
1000100P000000001
11111111111111111